111111111111111
100000000000001
101111110000001
100000000000001
100000001111111
10000000000W001
100000110100001
100000110000001
100100000010001
100000000100001
111111111111111