NO ./wall.xpm
SO ./wall.xpm
WE ./wall.xpm
EA ./wall.xpm

F 0,0,0
C 0,255,255

11111111111111111
111111111 1110001
100000000100001D1
111111011100E0001
10000000000000001
10000000001110111
10000000000000001
10000000110100001
10000000110000001
10000100000010001
10000000000100001
11111111111111111