NO ./textures/jungle/1.xpm
SO ./textures/jungle/2.xpm
WE ./textures/jungle/3.xpm
EA ./textures/jungle/4.xpm

F 51, 25, 0
C 99,99,99

11111111111111111111
11110000000000000N11
11110111111111111111
11110000000000000011
11110111111111111111
11110000000000000011
11110111111111111111
11110000000000000011
11110111111111111111
11110000000000000011
11110001111111111111
11110001000000000011
11110101111111111111
11110000000000000011
111101111111111D1111
11110000000000000011
11110000000000000011
11111111111111111111
11111111111111111111


















