NO ./textures/north.xpm
SO ./textures/south.xpm
WE ./textures/west.xpm
EA ./textures/east.xpm

F 255,255,0
C 255,0,0

111111111111111111111
100000001D10000000001
100000001D10000000001
100000001D10000000001
100000001D10000000001
100000001D10000000001
100000000000N00000001
111111111111111111111