NO ./textures/north.xpm
SO ./textures/south.xpm
WE ./textures/west.xpm
EA ./textures/east.xpm

F 255,255,0
C 255,0,0

        1111111111111111111111111111
        1000000000110000000000001
        1D11000001110000000000001
        10010000000D0000000000001
111111111011000001110000000000001
10000000001100000111D111111111111
11110111111111D11100000010001
11110111111111011101010010001
11000000110101011100000010001
100000000000000011000000D0001
10000000000000001101010010001
1100000111010101111101111N0111
11110111 1110101 101111010001
11111111 1111111 111111111111