NO ./textures/maze/1.xpm
SO ./textures/maze/2.xpm
WE ./textures/maze/3.xpm
EA ./textures/maze/4.xpm

F 76,76,76
C 99,99,99

111111111111111111111111111111
1N000000000000000000000000001
101111111111111D11111111110101
100000000100000000100000000001
101011111101111111111111111101
100010000100000000100000100001
101011D11110111111111011111101
100000100000000000000000000001
111111111111101111111111111101
100000000000000000000000000001
10111111111D111111111111111101
100000000100000000100000100001
101011111111111111D11111111101
100000000000000000000000000001
101011111101111111101111111101
100010000100000000100000100001
1D1D1010111111111D111101101001
100000000000000000000000000001
111111111101111111111111111101
100000000000000000000000000001
1011111111111111111111111111D1
100000100000000000000000100001
101011111111111111111111111101
100000000000000000000000000001
11111D111101111111111111111101
100000000000000000000000000001
101111111111111D11111111111101
100000000000000000000000000001
111111111111111111111111111111

