NO ./textures/space/1.xpm
SO ./textures/space/2.xpm
WE ./textures/space/3.xpm
EA ./textures/space/4.xpm

F 76,76,76
C 99,99,99

        1111111111111111111111111111
        100D000000110000000000001
        1011000001110000000000001
        10010000000D0000000000001
111111111D11000001110000000000001
10000000001100000111D111111111111
11110111111111D11100000010001
11110111111111011101010010001
11000000110101011100000010001
100000000000000011000000D0001
10000000000000001101010010001
1100000111010101111101111N0111
11110111 1110101 101111010001
11111111 1111111 111111111111