NO ./textures/space/1.xpm
SO ./textures/space/2.xpm
WE ./textures/space/3.xpm
EA ./textures/space/4.xpm

F 76,76,76
C 99,99,99

11111111111111111111
1N000000000000000001
101111111111111D1111
10000000010000000001
10101111110111111111
100010000100000100001
101011111101111111101
100000000000000000001
11111111111111111111
100000000000000000001
101111111111111111101
100000000100000000001
101011111101111111101
100010000100000100001
101011111101111111101
100000000000000000001
11111111111111111111

